200000000000000
020000100100002
001000000000010
002022200222020
002020000002020
002220122102220
000000200200000
000000200200000
002220122102220
002020000002020
002022200222020
001000000000010
020000000000002
200000100100000