400000000000000
040000300300004
003000000000030
004044400444040
004040000004040
004440344304440
000000400400000
000000400400000
004440344304440
004040000004040
004044400444040
003000000000030
040000000000004
400000300300000